TTTTTTTTTTTTTT
T    T   R T T
T R  T   T T T
T    T   T T T
T   R T  T T T
T    T   T T T
T    T   T T T
T  RTTT  T T T
TTTTTTTTTTTTTT